#################################
#P...........##...........E....G#
#.##########.##.##########.###..#
#....o................o....#....#
#.####.##########.####.####.#.####
#......#....T....#..#......#....#
######.#.######.#..#.######.##..#
#......#...##...#..#...##...#...#
#.########.##.###..###.##.###.###
#....o........K..D...........o..#
#.##########.##.##########.###..#
#............##.............#...#
#..E........................#...#
#################################
