###############################
#P.....#.............#.......G#
#.###..#.####..####..#.#####..#
#...#..#....#..#..#..#.....#..#
#.#.#..####.#..#..####.###.#..#
#.#......o..#..#..o....#...#..#
#.######.####..####.######.#..#
#......#....T....T.....#...#..#
####.#.#.############.#.###.###
#....#.#....K..D..o...#.....E.#
#.####.####.####.####.#######.#
#............##...............#
#..E..........................#
###############################
