############################
#P...........##...........G#
#.####.#####.##.#####.####.#
#.#..#.....#....#.....#..#.#
#.#..#.###.#.##.#.###.#..#.#
#......#o..#....#..o#......#
##...##.###.####.###.#######
#......#....T..T....#......#
#.####.#....#######.#.####.#
#...o..#....K..D....#..o...#
#.####.#####.##.#####.####.#
#............##............#
#..E....................E..#
############################
